# # # # # # # # # # # # # # # # #
# # # # # # . . . . . # # # # # #
# # # # # # . # # # . # # # # # #
# # # # # # . . . . . # # # # # #
# # # # # # . # . # . # # # # # #
# # # # # # . # . # . # # # # # #
# . . . . . . # . # . . . . . . #
# . # # # . # # . # # . # # # . #
# . . . . . . . . . . . . . . . #
# . # # # . # # . # # . # # # . #
# . . . . . . # . # . . . . . . #
# # # # # # . # . # . # # # # # #
# # # # # # . # . # . # # # # # #
# # # # # # . . . . . # # # # # #
# # # # # # . # # # . # # # # # #
# # # # # # . . . . . # # # # # #
# # # # # # # # # # # # # # # # #

